MockIM3	k__Animalia;p__Arthropoda;c__Insecta;o__Diptera;f__Culicidae
MockIM4	k__Animalia;p__Arthropoda;c__Insecta;o__Lepidoptera;f__Noctuidae;g__Agrotis
MockIM5	k__Animalia;p__Arthropoda;c__Insecta;o__Hemiptera;f__Aphididae;g__Aphis
MockIM7	k__Animalia;p__Arthropoda;c__Insecta;o__Trichoptera;f__Leptoceridae;g__Ceraclea;s__Ceraclea maculata
MockIM10	k__Animalia;p__Arthropoda;c__Insecta;o__Lepidoptera;f__Tortricidae;g__Choristoneura
MockIM15	k__Animalia;p__Arthropoda;c__Insecta;o__Diptera;f__Bombyliidae;g__Lepidophora
MockIM16	k__Animalia;p__Arthropoda;c__Insecta;o__Lepidoptera;f__Crambidae
MockIM20	k__Animalia;p__Arthropoda;c__Insecta;o__Lepidoptera;f__Geometridae;g__Haematopis;s__Haematopis grataria
MockIM21	k__Animalia;p__Arthropoda;c__Insecta;o__Coleoptera;f__Coccinellidae;g__Harmonia;s__Harmonia axyridis
MockIM23	k__Animalia;p__Arthropoda;c__Insecta;o__Coleoptera;f__Coccinellidae;g__Harmonia;s__Harmonia axyridis
MockIM27	k__Animalia;p__Arthropoda;c__Insecta;o__Coleoptera;f__Hydrophilidae;g__Cercyon;s__Cercyon praetextatus
MockIM28	k__Animalia;p__Arthropoda;c__Insecta;o__Lepidoptera;f__Erebidae;g__Hyphantria;s__Hyphantria cunea
MockIM29	k__Animalia;p__Arthropoda;c__Insecta;o__Lepidoptera;f__Erebidae
MockIM32	k__Animalia;p__Arthropoda;c__Insecta;o__Ephemeroptera;f__Heptageniidae;g__Leucrocuta;s__Leucrocuta maculipennis
MockIM33	k__Animalia;p__Arthropoda;c__Insecta;o__Neuroptera;f__Mantispidae;g__Dicromantispa;s__Dicromantispa sayi
MockIM39	k__Animalia;p__Arthropoda;c__Insecta;o__Coleoptera;f__Chrysomelidae;g__Ambiguous_taxa;s__Ambiguous_taxa
MockIM40	k__Animalia;p__Arthropoda;c__Insecta;o__Blattodea;f__Blattidae;g__Periplaneta;s__Periplaneta fuliginosa
MockIM42	k__Animalia;p__Arthropoda;c__Arachnida;o__Opiliones;f__Phalangiidae
MockIM44	k__Animalia;p__Arthropoda;c__Insecta;o__Diptera;f__Chironomidae;g__Procladius
MockIM46	k__Animalia;p__Arthropoda;c__Insecta;o__Coleoptera;f__Scarabaeidae;g__Euphoria;s__Euphoria fulgida
MockIM47	k__Animalia;p__Arthropoda;c__Insecta;o__Orthoptera;f__Tettigoniidae;g__Scudderia
MockIM49	k__Animalia;p__Arthropoda;c__Insecta;o__Blattodea;f__Ectobiidae;g__Supella;s__Supella longipalpa
MockIM53	k__Animalia;p__Arthropoda;c__Insecta;o__Lepidoptera;f__Crambidae
